NO assets/no.xpm
SO assets/so.xpm
EA assets/ea.xpm
WE assets/we.xpm

F 0, 0, 0
C 0, 255, 0

11111
1N001
10001
10001
10001
11111

0
